############################
#............##............#
#.####.#####.##.#####.####.#
#X#  #.#   #.##.#   #.#  #X#
#.####.#####.##.#####.####.#
#..........................#
#.####.##.########.##.####.#
#.####.##.########.##.####.#
#......##....##....##......#
######.#####0##0#####.######
     #.#####0##0#####.#
     #.##0000000000##.#
     #.##0|--~~--|0##.#
######.##0|~~~~~~|0##.######
#......000|~~~~~~|000......#
######.##0|~~~~~~|0##.######
     #.##0|------|0##.#
     #.##0000000000##.#
     #.##0########0##.#
######.##0########0##.######
#............##............#
#.####.#####.##.#####.####.#
#X####.#####.##.#####.####X#
#...##....... P.......##...#
###.##.##.########.##.##.###
###.##.##.########.##.##.###
#......##....##....##......#
#.##########.##.##########.#
#.##########.##.##########.#
#..........................#
############################